Label,VoxelCount,Volume,Subtracted_Volume,Volume_Delta,Centroid.X,Centroid.Y,Centroid.Z
1,30364,30364,30235,129,506.142,137.317,11.454
2,28139,28139,28127,12,548.209,157.526,13.022
3,26241,26241,26074,167,577.228,160.454,9.652
4,28444,28444,28367,77,608.826,162.637,13.835
5,49159,49159,49071,88,795.200,157.736,17.284
6,30052,30052,29964,88,302.575,178.814,11.382
7,39107,39107,39066,41,440.020,172.467,15.885
8,29822,29822,29822,0,768.618,162.363,15.737
9,26446,26446,26187,259,688.258,196.040,8.368
10,18632,18632,18596,36,768.935,199.817,6.192
11,27951,27951,27938,13,395.327,197.618,11.592
12,35116,35116,35078,38,857.079,201.262,8.721
13,26342,26342,26315,27,637.856,213.569,9.581
14,24207,24207,24195,12,611.481,228.844,9.430
15,20320,20320,20216,104,735.628,223.357,6.933
16,27893,27893,27912,-19,332.561,222.217,9.398
17,26353,26353,26314,39,529.016,224.885,10.765
18,66342,66342,66133,209,570.457,238.723,17.333
19,15188,15188,15089,99,478.939,228.700,5.161
20,25943,25943,25911,32,435.001,235.337,9.500
21,29658,29658,29577,81,824.410,231.238,9.846
22,21755,21755,21709,46,756.098,237.888,10.613
23,34524,34524,34401,123,775.870,214.410,18.301
24,33834,33834,33834,0,792.243,251.942,9.870
25,28899,28899,28871,28,867.942,254.151,8.378
26,28163,28163,27819,344,164.891,241.143,9.924
27,32065,32065,32065,0,643.398,249.442,16.895
28,29050,29050,29050,0,541.073,258.765,11.829
29,15280,15280,15280,0,511.441,259.682,6.734
30,25972,25972,25910,62,625.341,269.871,11.090
31,16966,16966,16966,0,664.620,274.390,5.413
32,24401,24401,24401,0,684.788,261.058,11.419
33,25434,25434,25434,0,383.112,253.439,13.414
34,26743,26743,26733,10,222.395,254.837,10.646
35,19716,19716,19774,-58,436.043,272.269,5.841
36,28558,28558,28491,67,728.399,268.876,11.846
37,12719,12719,12822,-103,400.034,273.304,7.131
38,14053,14053,14053,0,120.254,259.552,10.777
39,80313,80313,80256,57,757.686,277.627,19.624
40,10262,10262,10262,0,101.268,263.547,7.947
41,23854,23854,23696,158,704.737,280.679,12.084
42,39911,39911,39675,236,836.396,269.106,13.765
43,31338,31338,31338,0,310.978,259.650,18.255
44,13269,13269,13269,0,320.911,281.588,5.793
45,29963,29963,29944,19,499.632,281.688,13.974
46,29513,29513,29513,0,601.002,285.313,10.412
47,34079,34079,34018,61,468.761,295.006,12.632
48,20894,20894,20848,46,235.369,288.168,6.463
49,52657,52657,52647,10,910.798,288.636,14.568
50,13273,13273,13278,-5,521.824,297.849,5.462
51,21971,21971,22008,-37,637.440,306.090,7.216
52,29504,29504,29504,0,160.337,289.592,8.945
53,34080,34080,34032,48,972.136,288.491,12.939
54,34681,34681,34599,82,561.885,319.169,11.912
55,23031,23031,22992,39,362.464,302.314,13.780
56,28089,28089,28052,37,729.762,313.057,7.051
57,18813,18813,18813,0,409.037,322.726,7.426
58,21792,21792,21792,0,334.216,315.474,12.633
59,31233,31233,31216,17,486.684,323.074,8.771
60,29629,29629,29629,0,769.557,321.217,10.358
61,37420,37420,37295,125,588.074,333.623,10.601
62,13353,13353,13362,-9,7.304,323.651,12.320
63,20933,20933,20934,-1,272.697,331.485,5.537
64,27165,27165,27079,86,692.104,325.525,11.686
65,20559,20559,20585,-26,532.178,329.476,9.703
66,29597,29597,29597,0,828.607,337.877,6.203
67,31319,31319,31202,117,620.512,337.898,11.376
68,41918,41918,41865,53,448.366,353.324,11.939
69,27189,27189,27136,53,202.950,328.621,15.109
70,26184,26184,26251,-67,365.877,335.279,12.967
71,56373,56373,56345,28,734.764,358.864,11.682
72,38054,38054,38028,26,504.521,366.624,9.758
73,30713,30713,30807,-94,779.386,359.711,8.245
74,15233,15233,15220,13,309.049,355.503,8.618
75,14440,14440,14360,80,367.013,365.591,7.031
76,35075,35075,35065,10,657.070,340.237,13.154
77,32951,32951,32968,-17,484.381,354.590,20.254
78,28842,28842,28838,4,268.079,359.305,16.481
79,39281,39281,39269,12,597.505,370.383,13.115
80,24679,24679,24307,372,640.152,378.193,7.815
81,29438,29438,29384,54,701.806,382.194,6.067
82,52624,52624,52722,-98,805.122,354.529,18.183
83,19804,19804,19812,-8,392.755,380.292,8.610
84,23437,23437,23437,0,563.860,384.849,8.422
85,34507,34507,34492,15,531.937,382.827,10.934
86,9939,9939,9976,-37,157.211,388.079,3.877
87,29528,29528,29557,-29,893.207,362.428,13.845
88,32194,32194,32024,170,665.528,375.608,18.352
89,21024,21024,21024,0,302.709,382.810,12.783
90,38483,38483,38508,-25,265.781,389.352,15.918
91,14451,14451,14459,-8,330.362,393.655,8.542
92,46546,46546,46739,-193,792.874,389.647,16.458
93,39064,39064,39093,-29,754.269,404.638,10.823
94,13243,13243,13243,0,498.761,403.292,6.371
95,17815,17815,17789,26,620.261,405.638,10.518
96,8032,8032,8032,0,181.631,402.690,4.340
97,7229,7229,7229,0,381.827,410.379,4.124
98,26724,26724,26687,37,645.312,417.801,10.648
99,21404,21404,21400,4,684.049,418.969,6.904
100,49043,49043,49043,0,34.874,412.283,20.457
101,18430,18430,18430,0,324.488,418.316,8.848
102,25383,25383,25374,9,897.683,400.956,14.192
103,45925,45925,45925,0,434.922,422.613,16.239
104,15761,15761,15761,0,599.602,423.899,7.837
105,17226,17226,17226,0,463.410,425.229,8.732
106,22843,22843,22839,4,482.139,433.438,15.526
107,13786,13786,13786,0,506.881,431.992,7.474
108,19114,19114,19114,0,529.897,432.240,9.854
109,17604,17604,17604,0,549.876,437.060,7.970
110,43791,43791,43791,0,569.636,431.166,17.685
111,24367,24367,24367,0,109.548,429.198,7.327
112,30316,30316,30305,11,284.078,438.271,10.635
113,24598,24598,24567,31,800.755,426.197,11.000
114,11917,11917,11917,0,165.064,441.213,5.410
115,25615,25615,25615,0,880.776,426.980,11.092
116,31418,31418,31330,88,703.102,436.136,17.225
117,9675,9675,9675,0,390.681,436.030,6.796
118,17813,17813,17813,0,372.945,447.975,11.090
119,46827,46827,46752,75,676.856,451.272,16.241
120,22009,22009,22009,0,733.062,449.614,7.903
121,4085,4085,4085,0,323.076,444.850,3.906
122,37206,37206,37206,0,611.527,453.064,11.484
123,40136,40136,40118,18,772.675,445.467,12.038
124,12038,12038,12038,0,451.046,455.009,6.911
125,16681,16681,16681,0,143.943,460.617,5.960
126,31931,31931,31931,0,46.036,453.918,22.482
127,7066,7066,7066,0,313.511,465.250,4.469
128,4243,4243,4367,-124,654.532,463.442,3.523
129,15400,15400,15331,69,476.273,468.958,7.002
130,21375,21375,21375,0,395.436,469.702,7.724
131,25326,25326,25326,0,878.363,468.758,11.596
132,31835,31835,31835,0,928.694,474.567,11.391
133,39664,39664,39664,0,513.863,460.427,16.408
134,49561,49561,49338,223,744.310,468.237,16.038
135,16167,16167,16167,0,583.989,482.028,6.084
136,26306,26306,26297,9,581.278,454.573,24.738
137,38576,38576,38576,0,365.386,475.745,16.556
138,14029,14029,14012,17,554.680,481.232,7.472
139,16410,16410,16407,3,449.870,483.516,9.100
140,23461,23461,23461,0,117.613,482.254,8.914
141,38889,38889,38878,11,231.416,481.775,13.460
142,12695,12695,12695,0,857.630,497.183,5.650
143,43910,43910,43910,0,677.248,504.124,10.053
144,44661,44661,44591,70,528.805,492.513,17.388
145,26248,26248,26171,77,427.487,480.151,17.616
146,11898,11898,11884,14,626.440,503.364,4.135
147,20520,20520,20504,16,709.957,495.544,7.464
148,41752,41752,41585,167,602.674,501.215,16.953
149,19138,19138,19138,0,783.183,513.809,6.708
150,1061,1061,1061,0,137.394,495.453,10.858
151,42382,42382,42283,99,470.531,504.468,17.360
152,10956,10956,10956,0,122.775,505.133,9.670
153,27739,27739,27747,-8,410.851,510.092,7.996
154,342,342,342,0,109.056,499.468,12.132
155,9549,9549,9549,0,822.127,527.192,3.712
156,21545,21545,21545,0,238.600,511.242,15.592
157,9344,9344,9344,0,653.516,523.482,4.315
158,5144,5144,5144,0,540.847,521.822,4.411
159,22830,22830,22830,0,171.127,526.606,8.438
160,27678,27678,27678,0,1004.878,515.248,13.979
161,30450,30450,30423,27,73.078,520.792,23.442
162,34722,34722,34704,18,367.045,533.358,17.579
163,6245,6245,6245,0,505.702,530.746,3.872
164,9625,9625,9615,10,588.170,538.838,5.992
165,28557,28557,28583,-26,565.873,533.016,15.106
166,22526,22526,22628,-102,874.597,534.626,9.147
167,30720,30720,30720,0,316.440,545.220,10.739
168,16234,16234,16172,62,424.529,544.662,8.228
169,89548,89548,89548,0,618.316,539.747,21.602
170,21585,21585,21583,2,275.422,544.250,8.533
171,44105,44105,44105,0,543.884,563.863,9.977
172,17422,17422,17422,0,196.312,553.287,9.151
173,26544,26544,26537,7,83.851,554.567,10.045
174,10025,10025,9992,33,785.248,552.567,4.641
175,19156,19156,19156,0,346.307,559.624,11.123
176,24899,24899,24899,0,31.845,545.557,11.937
177,1665,1665,1665,0,159.162,542.468,4.443
178,38091,38091,38086,5,513.905,553.906,15.730
179,409,409,409,0,658.313,544.440,2.719
180,36362,36362,36302,60,476.917,554.861,13.708
181,16187,16187,16171,16,210.192,572.063,8.592
182,67126,67126,67044,82,676.062,559.705,19.880
183,21523,21523,21523,0,855.990,562.577,8.523
184,23193,23193,23193,0,720.635,575.818,7.478
185,72703,72703,72611,92,642.503,571.423,19.380
186,10425,10425,10420,5,574.722,573.456,6.103
187,14371,14371,14371,0,244.574,577.360,5.364
188,9106,9106,9106,0,417.209,585.173,4.650
189,40219,40219,40219,0,585.176,576.320,21.749
190,27412,27412,27412,0,401.372,577.173,18.037
191,14598,14598,14598,0,802.107,588.240,6.229
192,5740,5740,5625,115,480.613,591.183,6.155
193,26952,26952,26952,0,453.103,604.057,6.613
194,30623,30623,30484,139,506.434,602.008,9.112
195,18675,18675,18675,0,632.426,600.472,9.061
196,30272,30272,30272,0,434.597,588.735,22.354
197,26079,26079,26079,0,610.806,619.030,7.822
198,16453,16453,16453,0,580.065,614.238,6.430
199,22550,22550,22484,66,57.720,601.706,10.198
200,16475,16475,16475,0,355.842,614.870,5.692
201,21651,21651,21628,23,650.795,622.753,10.165
202,23426,23426,23426,0,416.973,623.089,10.727
203,28786,28786,28784,2,174.468,637.589,11.322
204,26232,26232,26231,1,695.761,616.081,11.660
205,6644,6644,6644,0,242.788,631.429,3.476
206,11865,11865,11842,23,491.889,631.467,5.817
207,22589,22589,22577,12,881.102,629.511,10.045
208,15435,15435,15410,25,138.106,624.507,10.105
209,24014,24014,23988,26,526.652,631.581,11.753
210,13155,13155,13153,2,558.683,637.505,6.232
211,13305,13305,13305,0,680.867,643.730,6.216
212,24604,24604,24626,-22,302.254,644.494,11.384
213,19410,19410,19406,4,731.185,639.649,7.714
214,19968,19968,19968,0,211.391,646.833,7.094
215,39464,39464,39439,25,468.808,632.574,19.051
216,24633,24633,24633,0,770.084,631.762,9.453
217,1463,1463,1463,0,140.888,640.427,4.923
218,15682,15682,15682,0,322.148,666.275,5.962
219,561,561,561,0,131.995,640.111,3.387
220,34794,34794,34780,14,627.604,670.905,12.637
221,13843,13843,13843,0,512.486,657.864,7.482
222,997,997,997,0,122.579,639.975,6.484
223,19245,19245,19245,0,116.768,648.819,10.283
224,16093,16093,16093,0,657.170,660.446,6.082
225,18961,18961,18954,7,450.213,661.603,9.673
226,18884,18884,18862,22,483.789,662.958,9.143
227,21949,21949,21949,0,704.762,659.403,9.226
228,40285,40285,40285,0,548.005,673.644,13.412
229,19294,19294,19257,37,580.117,671.637,7.614
230,34938,34938,34867,71,602.228,654.911,15.727
231,39947,39947,39884,63,425.416,686.404,17.523
232,22086,22086,21972,114,281.262,676.678,9.655
233,16899,16899,16892,7,221.299,692.209,9.157
234,25645,25645,25639,6,402.017,680.103,15.744
235,38065,38065,38065,0,521.309,690.816,16.156
236,15190,15190,15190,0,451.628,691.861,6.856
237,36979,36979,36979,0,799.031,696.247,11.887
238,28051,28051,28051,0,615.059,701.801,7.307
239,11862,11862,11830,32,570.510,708.335,4.806
240,18183,18183,18183,0,501.803,707.943,8.907
241,26563,26563,26576,-13,379.028,715.796,10.805
242,45304,45304,45304,0,541.272,732.919,10.802
243,25843,25843,25824,19,477.008,724.472,11.239
244,26219,26219,26219,0,653.663,713.873,10.396
245,42994,42994,42983,11,456.241,713.597,21.805
246,23006,23006,22996,10,212.260,727.979,10.878
247,16054,16054,16054,0,406.416,738.101,6.091
248,40911,40911,40911,0,303.949,731.506,18.669
249,22700,22700,22596,104,430.308,735.814,12.125
250,34818,34818,34818,0,590.123,728.191,13.260
251,20575,20575,20496,79,88.291,718.684,9.724
252,16721,16721,16721,0,322.758,736.990,9.185
253,22660,22660,22660,0,360.780,751.576,10.185
254,24481,24481,24481,0,241.259,739.673,13.742
255,21017,21017,20912,105,492.609,746.634,11.030
256,23155,23155,23155,0,573.955,761.420,6.335
257,21143,21143,21115,28,447.224,753.893,10.556
258,20976,20976,20976,0,279.386,762.281,10.495
259,18889,18889,18889,0,334.713,761.346,13.336
260,29672,29672,29672,0,177.892,754.170,15.473
261,19573,19573,19573,0,515.339,772.831,6.751
262,22105,22105,22105,0,788.091,758.616,11.642
263,25044,25044,25044,0,472.178,776.837,12.942
264,37406,37406,37406,0,703.114,778.086,9.213
265,20592,20592,20592,0,603.736,781.730,8.032
266,16748,16748,16708,40,626.825,794.903,4.714
267,20511,20511,20511,0,346.522,791.166,7.836
268,23842,23842,23727,115,376.003,794.296,13.897
269,17423,17423,17409,14,282.552,793.876,7.742
270,19402,19402,19402,0,474.853,809.604,9.805
271,19797,19797,19797,0,525.309,808.412,8.132
272,19124,19124,19115,9,501.011,819.708,7.041
273,25117,25117,25108,9,562.008,827.411,7.559
274,43050,43050,43050,0,452.547,835.333,13.077
275,26929,26929,26929,0,607.559,838.693,7.113
276,31387,31387,31385,2,400.846,849.766,10.676
277,42749,42749,42749,0,533.754,846.787,16.012
278,40588,40588,40408,180,1000.624,870.500,12.740
279,18640,18640,18616,24,991.374,898.318,6.569
280,28492,28492,28489,3,505.112,892.406,9.933
281,29255,29255,29255,0,358.446,903.419,9.134
282,27454,27454,27128,326,1012.434,931.458,11.850
283,36650,36650,36599,51,976.770,941.318,9.025
284,18667,18667,18578,89,1003.487,979.337,5.842
285,42952,42952,42432,520,965.772,977.468,13.038
286,20842,20842,20585,257,994.361,1006.433,14.764
287,1139,1139,1139,0,983.391,1004.386,1.539
288,351,351,351,0,973.165,1005.057,1.960
289,19172,19172,19106,66,918.540,1014.496,13.667
290,25713,25713,24557,1156,953.342,1010.499,13.667
291,1021,1021,1012,9,1014.360,1017.865,1.950
292,358,358,350,8,1001.983,1018.983,1.779
293,38705,38705,38560,145,731.724,163.676,14.755
294,28342,28342,28289,53,661.869,165.947,15.476
295,298,298,284,14,65.211,200.597,2.305
296,29948,29948,29948,0,461.098,208.201,15.688
297,31294,31294,31270,24,595.417,215.395,19.562
298,30865,30865,30865,0,273.369,292.650,16.533
299,28887,28887,28764,123,433.155,300.858,15.232
300,23502,23502,23502,0,103.894,363.650,14.837
301,24401,24401,24393,8,996.329,372.196,11.648
302,28787,28787,28787,0,547.575,381.499,26.081
303,39084,39084,39050,34,704.995,402.678,22.569
304,29268,29268,29164,104,583.786,401.021,21.004
305,873,873,873,0,58.929,463.977,4.633
306,191,191,191,0,102.414,475.351,5.466
307,24239,24239,24217,22,11.676,497.795,12.012
308,22882,22882,22874,8,1000.615,543.997,13.727
309,10367,10367,10367,0,152.511,550.516,10.182
310,21181,21181,20979,202,38.135,585.476,13.094
311,19925,19925,19925,0,234.076,597.348,17.372
312,24808,24808,24808,0,561.784,608.456,26.227
313,170,170,170,0,130.641,646.012,2.782
314,42730,42730,42730,0,319.609,789.584,19.987
315,26577,26577,26577,0,501.841,782.407,27.964
316,665,665,665,0,1021.126,840.451,4.656
317,28442,28442,28426,16,576.323,861.075,12.956
318,29640,29640,29631,9,636.662,152.603,17.841
319,28323,28323,28068,255,692.670,160.037,16.636
320,51828,51828,51697,131,831.782,153.158,16.010
321,32368,32368,32299,69,393.057,156.499,14.678
322,40338,40338,40240,98,932.814,329.205,17.014
323,26632,26632,26629,3,335.430,493.829,18.292
324,252,252,252,0,1018.877,533.623,5.389
325,75,75,75,0,149.120,536.160,4.933
326,40109,40109,40109,0,323.099,600.854,22.044
327,35377,35377,35330,47,615.362,808.276,20.355
328,24252,24252,24218,34,363.943,856.297,15.160
329,38923,38923,38819,104,521.473,872.897,17.312
330,45149,45149,45147,2,486.235,997.223,17.580
331,27122,27122,27099,23,442.066,991.677,11.613
332,21213,21213,21122,91,685.676,110.543,11.936
333,26774,26774,26774,0,481.019,180.530,19.748
334,40200,40200,40171,29,707.822,232.088,18.143
335,23489,23489,23489,0,106.640,222.160,14.129
336,33165,33165,33125,40,662.953,305.719,22.315
337,45205,45205,45124,81,211.130,378.197,22.659
338,27512,27512,27492,20,349.753,367.663,21.560
339,219,219,219,0,1017.119,536.311,9.215
340,25353,25353,25335,18,992.616,572.603,15.921
341,28065,28065,28065,0,551.613,586.934,20.897
342,1045,1045,1045,0,139.981,649.257,7.143
343,31421,31421,31408,13,627.691,739.071,16.356
344,29867,29867,29867,0,571.959,755.123,25.151
345,38796,38796,38796,0,835.819,751.874,20.285
346,25824,25824,25824,0,437.149,803.629,18.878
347,30834,30834,30743,91,626.478,849.270,16.552
348,23014,23014,22975,39,390.825,881.384,14.887
349,43362,43362,43259,103,424.385,884.390,18.109
350,70715,70715,70392,323,427.342,930.934,14.659
351,445,445,445,0,464.393,960.227,5.196
352,32545,32545,32522,23,814.657,112.082,15.860
353,30638,30638,30568,70,778.273,114.101,19.564
354,34863,34863,34863,0,130.570,176.889,19.875
355,16740,16740,16740,0,1005.316,231.167,14.093
356,34984,34984,34834,150,840.886,311.265,17.673
357,27119,27119,27119,0,360.051,398.450,18.788
358,8047,8047,8047,0,1016.273,395.012,14.729
359,44448,44448,44409,39,709.359,521.560,20.056
360,327,327,327,0,236.015,619.471,6.657
361,21405,21405,21405,0,285.092,627.114,18.717
362,29639,29639,29599,40,574.697,688.502,25.097
363,25869,25869,25869,0,343.661,714.028,19.889
364,31191,31191,31087,104,507.507,720.949,26.472
365,19235,19235,19235,0,542.676,740.143,29.752
366,34652,34652,34462,190,27.005,791.247,18.066
367,10226,10226,10226,0,399.275,806.254,11.727
368,63601,63601,63592,9,514.952,927.075,18.617
369,27750,27750,27572,178,511.752,199.925,18.167
370,30866,30866,30866,0,285.480,215.781,23.017
371,45465,45465,45447,18,548.649,292.642,26.964
372,30931,30931,30879,52,798.710,305.126,19.915
373,25578,25578,25578,0,88.887,308.726,22.367
374,27986,27986,27986,0,853.978,352.149,19.620
375,43264,43264,43262,2,162.220,369.965,23.442
376,30016,30016,30001,15,417.490,396.141,22.771
377,19919,19919,19919,0,182.628,475.074,19.497
378,28365,28365,28365,0,173.668,586.145,18.508
379,21484,21484,21484,0,915.870,625.408,17.926
380,26363,26363,26363,0,315.980,690.546,19.775
381,29746,29746,29746,0,668.455,679.154,19.647
382,13226,13226,13217,9,954.610,725.705,13.972
383,46008,46008,46008,0,657.603,733.156,21.748
384,18852,18852,18837,15,84.141,756.876,16.459
385,34512,34512,34500,12,128.438,802.412,17.474
386,37477,37477,37419,58,221.243,804.402,25.272
387,20768,20768,20741,27,241.697,852.004,14.886
388,16882,16882,16882,0,588.155,948.448,10.907
389,234,234,234,0,464.517,955.731,6.979
390,47128,47128,46977,151,540.704,88.619,18.502
391,30608,30608,30579,29,800.496,187.621,24.510
392,23242,23242,23198,44,825.050,214.636,23.594
393,25739,25739,25736,3,23.251,265.918,21.588
394,28657,28657,28657,0,458.115,391.151,21.033
395,28837,28837,28837,0,485.967,403.126,25.990
396,41020,41020,41020,0,208.751,421.533,27.573
397,528,528,528,0,138.208,483.943,10.466
398,28419,28419,28419,0,927.898,539.820,20.194
399,7468,7468,7468,0,154.752,595.323,16.718
400,28099,28099,28099,0,796.845,607.864,20.560
401,1450,1450,1394,56,1.996,659.423,10.526
402,101,101,101,0,565.970,753.515,13.366
403,39005,39005,38840,165,461.517,889.169,22.706
404,24762,24762,24717,45,328.281,906.760,18.869
405,45499,45499,45499,0,362.886,944.418,19.807
406,20769,20769,20769,0,706.948,64.711,15.014
407,30971,30971,30971,0,733.688,90.265,22.665
408,25847,25847,25759,88,467.153,94.722,21.400
409,26938,26938,26800,138,374.964,125.577,17.251
410,31574,31574,31552,22,875.269,170.593,16.937
411,34983,34983,34951,32,922.966,180.926,18.464
412,28235,28235,28210,25,521.394,244.100,30.188
413,1076,1076,1076,0,46.964,285.935,11.089
414,23531,23531,23531,0,397.821,293.709,22.448
415,24200,24200,24200,0,76.339,451.449,22.330
416,28892,28892,28850,42,572.654,496.742,24.153
417,15817,15817,15817,0,240.150,704.181,18.933
418,29750,29750,29750,0,946.846,702.202,22.053
419,23865,23865,23865,0,783.781,793.807,16.256
420,27119,27119,27118,1,259.360,802.316,24.221
421,34048,34048,34023,25,180.401,827.085,20.557
422,23274,23274,23250,24,193.461,856.440,15.548
423,15440,15440,15440,0,551.640,887.193,16.593
424,24169,24169,24060,109,214.018,898.695,17.701
425,11846,11846,11843,3,565.728,70.120,17.612
426,27952,27952,27886,66,450.042,117.199,21.487
427,903,903,903,0,487.266,107.042,9.897
428,24614,24614,24614,0,340.393,144.835,20.605
429,25120,25120,24862,258,945.149,241.246,18.877
430,19247,19247,19218,29,983.795,247.216,20.943
431,31518,31518,31518,0,71.751,263.729,24.967
432,28205,28205,28163,42,353.670,266.122,23.134
433,34669,34669,34645,24,489.574,459.569,26.711
434,41573,41573,41573,0,722.379,573.882,28.113
435,13812,13812,13812,0,1016.254,599.737,22.598
436,14599,14599,14599,0,1014.715,648.345,21.206
437,32154,32154,32154,0,249.550,668.077,28.633
438,24884,24884,24884,0,388.622,665.265,23.740
439,35992,35992,35992,0,483.873,687.643,29.125
440,23304,23304,23295,9,17.868,751.411,20.595
441,24448,24448,24448,0,417.498,791.735,24.613
442,24276,24276,24276,0,109.501,844.739,23.702
443,33165,33165,33156,9,160.732,880.719,27.471
444,23591,23591,23591,0,356.574,888.684,22.271
445,31186,31186,31171,15,119.981,893.158,23.726
446,11663,11663,11651,12,559.472,49.642,20.209
447,46926,46926,46715,211,606.781,70.080,23.357
448,26534,26534,26534,0,801.157,83.641,24.684
449,47185,47185,46827,358,709.936,120.137,26.743
450,44303,44303,44203,100,852.713,134.284,25.732
451,32622,32622,32551,71,667.833,217.870,28.469
452,28712,28712,28691,21,492.443,240.910,24.615
453,27350,27350,27343,7,466.696,255.625,23.881
454,28088,28088,28056,32,931.178,362.773,23.453
455,33238,33238,33238,0,662.884,407.167,31.474
456,50800,50800,50800,0,779.365,484.652,24.554
457,26505,26505,26505,0,989.112,610.060,20.196
458,12242,12242,12191,51,6.141,616.956,23.443
459,30966,30966,30907,59,784.453,640.201,23.924
460,15602,15602,15602,0,14.670,681.391,20.532
461,12100,12100,12052,48,9.800,710.179,19.003
462,22627,22627,22627,0,214.533,760.537,22.883
463,29250,29250,29208,42,675.883,820.001,21.369
464,1544,1544,1544,0,392.780,825.758,14.129
465,37104,37104,37055,49,408.256,86.431,22.782
466,24317,24317,24265,52,884.568,85.266,21.946
467,21867,21867,21781,86,333.114,96.875,19.764
468,43236,43236,43042,194,901.917,150.655,26.466
469,18888,18888,18818,70,92.250,156.240,19.745
470,21696,21696,21696,0,380.396,274.924,27.465
471,29926,29926,29926,0,13.728,352.894,30.461
472,26039,26039,26000,39,909.311,410.192,25.934
473,44486,44486,44430,56,831.275,413.533,27.447
474,28082,28082,28082,0,798.141,457.828,24.531
475,29868,29868,29635,233,446.179,531.235,24.320
476,27259,27259,27257,2,645.586,646.299,23.773
477,29654,29654,29654,0,570.795,640.219,28.310
478,25173,25173,25173,0,172.147,722.298,24.571
479,21364,21364,21364,0,941.430,767.370,19.929
480,26460,26460,26460,0,311.914,871.670,23.368
481,24940,24940,24908,32,286.125,900.372,24.032
482,49100,49100,49082,18,605.550,893.375,24.585
483,44931,44931,44873,58,462.388,935.308,27.100
484,21003,21003,21003,0,553.991,944.175,20.838
485,16103,16103,16075,28,465.223,1013.137,20.152
486,24056,24056,24056,0,546.291,135.420,25.861
487,43498,43498,43342,156,627.046,128.172,29.226
488,28647,28647,28625,22,941.310,147.355,23.381
489,26729,26729,26713,16,375.366,177.206,27.691
490,26662,26662,26657,5,230.315,215.397,24.462
491,26663,26663,26663,0,862.649,291.786,26.273
492,840,840,840,0,888.326,290.323,26.023
493,39233,39233,39233,0,884.475,273.964,38.172
494,35582,35582,35544,38,689.129,364.934,29.376
495,44638,44638,44638,0,304.256,403.578,33.093
496,26062,26062,26062,0,749.422,580.324,27.328
497,12439,12439,12424,15,966.252,738.955,19.442
498,28314,28314,28314,0,373.150,828.458,29.213
499,27349,27349,27317,32,339.991,843.895,27.468
500,15575,15575,15575,0,217.260,853.270,24.726
501,27344,27344,27274,70,420.418,963.861,22.873
502,415,415,415,0,568.195,960.383,14.665
503,24978,24978,24970,8,532.822,52.558,23.661
504,41686,41686,41590,96,829.201,83.521,28.760
505,7356,7356,7356,0,875.639,110.528,22.133
506,29439,29439,29439,0,276.303,137.208,26.869
507,56902,56902,56756,146,956.504,167.707,30.852
508,26260,26260,26224,36,616.888,201.281,29.049
509,3025,3025,3025,0,130.635,389.798,17.005
510,24643,24643,24643,0,858.326,380.293,26.946
511,27916,27916,27899,17,249.023,434.439,28.653
512,30796,30796,30796,0,438.481,449.529,29.632
513,29976,29976,29976,0,948.717,475.437,27.961
514,25739,25739,25739,0,383.632,496.637,25.341
515,17334,17334,17334,0,483.084,526.055,27.711
516,20772,20772,20712,60,702.334,551.555,26.698
517,42252,42252,42188,64,470.394,573.545,33.134
518,2438,2438,2438,0,105.167,622.496,16.692
519,29960,29960,29960,0,541.685,633.476,32.112
520,44314,44314,44312,2,513.666,654.693,35.468
521,25087,25087,25087,0,73.475,666.487,28.045
522,24172,24172,24172,0,275.321,688.802,24.909
523,39941,39941,39940,1,50.424,721.130,29.790
524,21356,21356,21356,0,353.523,748.184,29.220
525,26852,26852,26852,0,391.952,777.597,27.663
526,29872,29872,29857,15,567.794,920.661,26.578
527,29366,29366,29310,56,923.234,117.190,26.256
528,35585,35585,35088,497,652.308,277.234,29.816
529,48037,48037,48009,28,573.870,289.512,32.921
530,52430,52430,52430,0,716.147,326.513,29.734
531,32382,32382,32197,185,729.436,487.928,29.021
532,41217,41217,41212,5,643.045,477.986,27.458
533,50349,50349,50233,116,679.570,473.463,37.798
534,36810,36810,36810,0,313.576,540.858,34.584
535,52189,52189,51890,299,522.673,593.531,37.301
536,24291,24291,24291,0,273.202,649.826,29.296
537,66107,66107,66107,0,838.852,697.421,38.968
538,28722,28722,28722,0,397.049,741.218,27.089
539,31103,31103,30977,126,533.799,773.591,29.976
540,53356,53356,53356,0,644.536,782.210,29.881
541,19804,19804,19804,0,72.709,822.185,24.625
542,27092,27092,27092,0,310.625,822.396,28.795
543,34308,34308,34308,0,393.158,913.869,29.850
544,47764,47764,47717,47,323.813,957.850,28.188
545,24781,24781,24781,0,572.469,974.969,23.895
546,20229,20229,20104,125,516.601,14.860,23.710
547,28977,28977,28733,244,496.498,45.828,27.197
548,25518,25518,25494,24,955.936,211.942,26.494
549,25639,25639,25639,0,258.309,244.405,25.912
550,42428,42428,42428,0,745.217,235.672,36.402
551,39468,39468,39417,51,309.749,482.293,31.464
552,25999,25999,25999,0,227.210,503.428,32.622
553,36909,36909,36909,0,580.382,550.534,39.779
554,38746,38746,38721,25,309.175,624.679,35.419
555,25387,25387,25387,0,352.274,636.511,27.601
556,52204,52204,51719,485,688.377,631.752,32.998
557,37658,37658,37647,11,562.744,785.456,31.890
558,37439,37439,37347,92,568.807,825.940,33.094
559,892,892,892,0,207.938,41.215,17.096
560,30218,30218,30178,40,427.891,47.233,26.321
561,23266,23266,23258,8,814.606,58.274,30.312
562,26708,26708,26700,8,231.023,123.629,25.928
563,28281,28281,28281,0,676.838,151.302,33.160
564,25733,25733,25733,0,307.382,283.818,36.771
565,52185,52185,52157,28,525.276,331.677,31.450
566,25960,25960,25960,0,390.772,341.455,31.901
567,37454,37454,37379,75,649.676,353.996,34.232
568,26301,26301,26248,53,737.398,521.844,29.184
569,20411,20411,20411,0,192.740,503.431,29.242
570,47460,47460,47400,60,775.554,517.068,34.845
571,21985,21985,21985,0,276.043,535.705,28.717
572,39385,39385,39298,87,414.060,545.182,35.606
573,28112,28112,28098,14,808.159,585.295,29.722
574,26971,26971,26971,0,374.643,612.312,29.744
575,44059,44059,44049,10,739.712,679.643,31.854
576,31448,31448,31448,0,686.154,730.802,30.770
577,36548,36548,36548,0,435.610,770.609,34.549
578,30021,30021,29963,58,511.399,806.512,29.164
579,26179,26179,26179,0,545.214,813.638,27.645
580,29035,29035,29035,0,491.015,834.810,32.865
581,21791,21791,21724,67,69.029,856.022,26.983
582,23556,23556,23482,74,151.143,996.562,26.062
583,26144,26144,26117,27,522.348,997.915,24.827
584,12453,12453,12425,28,945.109,52.208,25.428
585,26526,26526,26526,0,491.529,79.527,32.941
586,42655,42655,42387,268,602.034,111.243,36.487
587,29108,29108,29031,77,197.011,111.458,27.022
588,23857,23857,23857,0,207.858,169.179,32.119
589,31468,31468,31375,93,847.649,229.712,29.438
590,25630,25630,25620,10,745.302,384.823,29.259
591,60344,60344,60116,228,616.396,368.293,36.263
592,45676,45676,45676,0,795.111,418.218,35.787
593,23667,23667,23659,8,339.455,459.696,28.162
594,27387,27387,27387,0,961.451,448.953,33.802
595,23507,23507,23507,0,836.442,477.505,25.880
596,5180,5180,5169,11,417.111,502.869,23.898
597,38062,38062,38061,1,250.362,534.638,34.625
598,42794,42794,42794,0,96.866,602.667,39.751
599,38240,38240,38236,4,447.440,642.829,34.448
600,28150,28150,28008,142,707.955,680.340,31.698
601,22262,22262,22262,0,145.683,844.944,27.599
602,20692,20692,20689,3,102.202,939.705,25.918
603,19333,19333,19060,273,52.464,931.439,26.126
604,20882,20882,20838,44,134.849,959.094,26.739
605,29676,29676,29660,16,94.797,93.047,30.768
606,28196,28196,28196,0,496.381,155.604,31.915
607,22436,22436,22370,66,29.885,178.776,32.910
608,42473,42473,42435,38,822.045,185.701,36.720
609,23245,23245,23245,0,441.192,234.901,28.768
610,36326,36326,36289,37,675.707,238.657,40.070
611,28170,28170,28170,0,584.686,322.586,37.566
612,47702,47702,47702,0,578.656,364.862,38.014
613,24508,24508,24508,0,66.808,488.197,33.156
614,29629,29629,29616,13,919.155,489.537,33.201
615,27397,27397,27278,119,473.548,778.581,34.294
616,44093,44093,44080,13,634.188,828.236,33.962
617,45218,45218,45218,0,284.811,882.631,38.332
618,34587,34587,34563,24,468.619,870.788,35.094
619,28280,28280,28220,60,597.881,935.103,30.475
620,29423,29423,28282,1141,724.106,46.340,33.104
621,27040,27040,27029,11,272.500,106.665,35.852
622,18006,18006,17973,33,111.727,118.218,28.609
623,39921,39921,39824,97,777.689,250.243,38.297
624,36094,36094,35950,144,790.633,280.730,33.543
625,27411,27411,27411,0,480.784,332.933,35.076
626,4929,4929,4929,0,151.002,338.770,23.907
627,25000,25000,25000,0,194.209,342.844,34.499
628,46811,46811,46799,12,815.994,360.516,36.999
629,23036,23036,22721,315,773.655,366.324,33.220
630,11762,11762,11762,0,5.968,440.842,34.774
631,34133,34133,34085,48,499.459,482.927,38.155
632,168,168,168,0,1016.756,519.732,21.720
633,44480,44480,44480,0,839.771,658.239,36.348
634,46140,46140,46140,0,802.650,659.741,36.471
635,28949,28949,28765,184,593.019,691.208,32.990
636,31988,31988,31947,41,419.941,725.725,35.962
637,26500,26500,26462,38,719.514,726.384,33.691
638,26217,26217,26217,0,507.853,751.419,33.917
639,28135,28135,28135,0,675.593,867.712,32.452
640,19587,19587,19450,137,17.635,959.040,28.049
641,29613,29613,29573,40,478.083,964.972,30.489
642,52640,52640,52627,13,598.902,972.932,35.061
643,19078,19078,19031,47,36.566,993.978,30.050
644,35731,35731,35696,35,298.029,81.802,37.321
645,22485,22485,22402,83,329.216,72.290,28.981
646,29618,29618,29618,0,742.208,134.549,36.278
647,30282,30282,30282,0,574.805,163.001,29.364
648,27420,27420,27241,179,269.734,171.167,34.368
649,49643,49643,49529,114,482.408,292.515,37.514
650,29378,29378,29374,4,527.124,272.891,37.436
651,27571,27571,27571,0,415.178,319.904,34.216
652,47149,47149,47094,55,782.229,321.115,41.170
653,25651,25651,25644,7,115.372,337.740,35.488
654,24655,24655,24655,0,240.058,365.160,32.326
655,52712,52712,52712,0,989.158,459.532,44.718
656,22251,22251,22251,0,668.420,508.676,31.244
657,24252,24252,24252,0,348.337,573.275,36.347
658,169,169,169,0,159.893,600.503,20.000
659,22978,22978,22978,0,481.445,603.819,33.960
660,30683,30683,30680,3,120.005,616.686,33.467
661,26227,26227,26218,9,414.007,644.846,34.609
662,27121,27121,27121,0,369.347,703.167,34.253
663,26653,26653,26653,0,579.300,730.224,34.499
664,29423,29423,29404,19,342.723,810.812,35.680
665,23297,23297,23257,40,467.547,821.153,36.689
666,42785,42785,42315,470,419.484,851.738,41.822
667,36631,36631,36536,95,414.771,944.255,43.900
668,39591,39591,39375,216,315.831,993.875,31.420
669,25192,25192,25177,15,570.533,1005.590,28.872
670,26053,26053,26036,17,811.826,10.889,47.523
671,46501,46501,46295,206,860.752,57.126,36.348
672,17102,17102,17102,0,922.475,70.676,32.691
673,7076,7076,7076,0,942.401,80.198,24.427
674,30152,30152,30109,43,430.896,147.128,35.052
675,47337,47337,47337,0,632.823,201.875,43.673
676,27875,27875,27875,0,206.787,212.625,35.506
677,24168,24168,24168,0,35.031,234.786,37.213
678,29031,29031,29031,0,418.909,245.402,37.977
679,29934,29934,29934,0,443.557,272.301,35.064
680,22205,22205,22205,0,210.502,314.503,36.707
681,41188,41188,41188,0,736.155,424.753,37.117
682,26885,26885,26883,2,897.613,547.363,35.779
683,33245,33245,33245,0,941.775,575.885,41.325
684,37296,37296,37296,0,595.213,594.596,37.004
685,25791,25791,25781,10,627.904,609.181,34.625
686,48839,48839,48773,66,638.301,693.438,38.761
687,23989,23989,23985,4,748.097,738.101,34.469
688,19941,19941,19941,0,75.914,771.625,36.196
689,21075,21075,21070,5,99.655,784.025,34.133
690,30231,30231,30231,0,400.985,828.154,36.428
691,37869,37869,37822,47,447.165,832.149,40.967
692,24207,24207,24140,67,493.500,887.626,35.965
693,30406,30406,30298,108,320.340,923.887,34.701
694,15724,15724,15724,0,427.606,8.825,36.403
695,29084,29084,29053,31,258.478,61.231,35.666
696,47950,47950,47942,8,979.765,98.020,35.143
697,26959,26959,26896,63,665.446,115.863,36.611
698,24973,24973,24924,49,69.038,187.837,35.946
699,26681,26681,26681,0,530.425,198.055,35.471
700,29735,29735,29679,56,805.391,245.393,41.078
701,46417,46417,46417,0,724.620,297.596,37.531
702,42264,42264,42230,34,249.306,340.745,42.669
703,34356,34356,34356,0,507.820,373.937,38.640
704,32120,32120,32118,2,696.002,382.768,43.414
705,27777,27777,27777,0,383.904,391.959,36.576
706,45752,45752,45722,30,540.751,509.409,40.471
707,47586,47586,47580,6,534.299,547.851,41.716
708,25270,25270,25268,2,967.051,754.719,38.078
709,28850,28850,28703,147,675.664,921.798,34.207
710,30765,30765,30642,123,506.510,970.424,36.852
711,34337,34337,34253,84,452.033,985.352,37.320
712,28653,28653,28586,67,664.687,18.492,35.936
713,328,328,328,0,633.567,15.899,23.546
714,31299,31299,31256,43,687.911,51.875,36.540
715,31874,31874,31659,215,638.771,91.507,38.487
716,41814,41814,41768,46,530.919,133.963,41.484
717,43784,43784,43784,0,358.679,206.078,44.908
718,41940,41940,41937,3,442.016,207.417,41.341
719,23805,23805,23805,0,285.822,272.683,40.662
720,43677,43677,43677,0,415.935,356.206,40.581
721,28805,28805,28771,34,857.054,401.960,39.138
722,44059,44059,44038,21,532.295,430.899,36.995
723,35305,35305,35305,0,414.734,429.695,41.967
724,45063,45063,45048,15,697.306,441.992,39.559
725,17691,17691,17691,0,822.090,494.088,31.919
726,44226,44226,44209,17,404.040,510.642,43.335
727,37938,37938,37888,50,496.046,537.195,39.710
728,44074,44074,44074,0,446.116,599.666,43.525
729,22462,22462,22456,6,58.368,621.077,37.680
730,53217,53217,53212,5,604.285,652.837,38.945
731,29983,29983,29949,34,755.271,860.055,36.032
732,37792,37792,37792,0,344.444,877.551,43.527
733,41254,41254,41254,0,950.858,875.958,36.104
734,22108,22108,21912,196,82.461,997.318,37.398
735,2503,2503,2503,0,71.535,1018.595,27.617
736,30637,30637,30637,0,782.628,60.798,38.509
737,25829,25829,25539,290,193.355,69.310,31.556
738,49811,49811,49732,79,889.746,211.779,43.074
739,25676,25676,25676,0,170.754,278.009,40.778
740,28273,28273,28227,46,433.111,377.869,42.333
741,22611,22611,22452,159,46.142,391.159,38.460
742,42062,42062,42045,17,654.793,595.610,40.767
743,23676,23676,23667,9,809.346,605.248,39.806
744,29993,29993,29993,0,483.596,731.648,41.451
745,22595,22595,22595,0,25.363,848.141,39.382
746,48317,48317,48316,1,602.355,865.039,38.773
747,24782,24782,24782,0,696.303,863.373,36.437
748,23528,23528,23508,20,428.443,909.249,39.035
749,26789,26789,26748,41,193.219,936.595,37.268
750,11434,11434,11273,161,609.319,5.876,39.139
751,47731,47731,47484,247,746.927,59.897,45.727
752,26070,26070,25984,86,457.299,55.617,39.892
753,44643,44643,44625,18,501.195,207.067,46.633
754,42231,42231,42114,117,564.088,230.614,47.466
755,30510,30510,30494,16,859.938,222.415,44.349
756,33827,33827,33612,215,603.184,303.384,43.574
757,50112,50112,50047,65,933.526,301.894,42.128
758,28975,28975,28975,0,962.525,308.946,42.885
759,31806,31806,31795,11,469.744,366.389,45.056
760,25493,25493,25493,0,141.245,387.418,39.620
761,31922,31922,31830,92,440.827,504.141,42.593
762,40224,40224,40224,0,192.709,552.229,39.615
763,27068,27068,27068,0,836.451,556.586,38.975
764,22640,22640,22640,0,179.301,676.796,39.701
765,24909,24909,24909,0,269.278,780.983,41.932
766,21055,21055,21055,0,671.111,779.253,38.034
767,37122,37122,37112,10,966.209,782.029,46.754
768,49538,49538,49529,9,906.658,808.928,44.523
769,32870,32870,32773,97,544.913,854.817,39.291
770,33459,33459,33439,20,325.519,15.920,37.420
771,27409,27409,27403,6,379.023,71.175,39.369
772,33675,33675,33658,17,576.904,129.225,44.801
773,24396,24396,24353,43,205.764,144.848,40.311
774,40296,40296,40295,1,842.977,156.388,43.802
775,45314,45314,45247,67,587.980,206.168,42.663
776,30442,30442,30433,9,329.883,220.146,37.942
777,25373,25373,25373,0,56.575,219.575,41.891
778,48956,48956,48943,13,130.457,225.450,49.177
779,27773,27773,27773,0,978.738,227.816,39.970
780,23911,23911,23911,0,334.514,273.893,38.494
781,24888,24888,24888,0,27.987,293.711,40.383
782,54457,54457,54443,14,261.469,295.692,49.878
783,42237,42237,42237,0,66.010,311.122,45.363
784,43679,43679,43679,0,295.158,327.877,47.457
785,27012,27012,27012,0,303.744,365.829,36.495
786,25914,25914,25912,2,363.281,422.337,40.401
787,43143,43143,43143,0,849.914,433.487,41.340
788,36606,36606,36602,4,183.213,453.606,42.446
789,21163,21163,21163,0,131.934,449.516,38.545
790,16532,16532,16532,0,594.107,497.745,35.256
791,65,65,65,0,600.954,502.862,30.708
792,28658,28658,28653,5,369.985,652.982,43.141
793,29345,29345,29345,0,766.400,682.227,40.283
794,26963,26963,26772,191,543.254,672.528,38.042
795,26539,26539,26539,0,770.139,736.864,42.549
796,22143,22143,22088,55,863.063,738.573,41.195
797,23770,23770,23769,1,363.920,777.894,39.234
798,56348,56348,56328,20,587.339,804.268,46.037
799,24526,24526,24511,15,347.281,909.415,42.645
800,33584,33584,33584,0,189.611,910.181,45.801
801,38249,38249,38249,0,756.272,994.587,38.925
802,29079,29079,29027,52,432.138,1005.003,38.953
803,40848,40848,40759,89,519.396,1006.550,43.821
804,10949,10949,10773,176,683.834,1013.725,34.364
805,25237,25237,25213,24,478.094,14.908,43.345
806,34184,34184,34158,26,581.849,72.512,41.165
807,21887,21887,21875,12,1006.577,61.002,39.292
808,28353,28353,28299,54,9.916,81.534,44.954
809,41210,41210,41210,0,1005.046,181.322,45.721
810,54810,54810,54810,0,394.535,227.805,43.414
811,26545,26545,26545,0,265.152,225.538,41.338
812,29092,29092,29092,0,835.351,264.130,40.486
813,41374,41374,41338,36,318.822,331.824,47.356
814,32588,32588,32588,0,733.252,324.382,44.741
815,27140,27140,27140,0,456.961,333.885,43.796
816,25342,25342,25342,0,273.394,482.355,43.157
817,22568,22568,22568,0,261.276,626.634,42.357
818,25370,25370,25370,0,334.579,652.053,41.919
819,22816,22816,22812,4,112.472,665.308,39.252
820,26144,26144,26144,0,587.156,760.236,39.097
821,21022,21022,21022,0,198.613,779.441,41.262
822,24132,24132,24129,3,605.405,900.468,40.500
823,57718,57718,57702,16,236.242,933.658,49.423
824,35707,35707,35685,22,399.972,971.109,44.269
825,231,231,231,0,133.113,987.082,28.177
826,19712,19712,19685,27,117.061,993.238,52.209
827,13514,13514,13514,0,120.804,1014.785,41.071
828,42199,42199,42137,62,717.007,18.191,47.444
829,32591,32591,32543,48,581.329,18.593,45.023
830,17310,17310,17299,11,1007.631,104.190,41.370
831,35841,35841,35789,52,502.612,125.098,45.278
832,25567,25567,25564,3,313.887,156.174,40.805
833,32665,32665,32644,21,750.927,189.394,42.773
834,41498,41498,41490,8,99.828,232.280,49.541
835,21913,21913,21913,0,115.243,431.010,43.147
836,29987,29987,29983,4,14.181,475.950,45.518
837,27782,27782,27782,0,719.560,602.397,42.220
838,39173,39173,39173,0,23.291,604.136,49.573
839,23723,23723,23723,0,234.051,622.116,41.377
840,27562,27562,27562,0,633.336,630.723,44.360
841,16248,16248,16248,0,9.393,641.952,41.103
842,19561,19561,19540,21,126.969,777.625,43.544
843,38177,38177,38177,0,287.319,815.929,46.244
844,10845,10845,10844,1,129.718,852.094,40.021
845,1436,1436,1436,0,101.359,901.355,35.307
846,41572,41572,41488,84,376.220,887.434,50.376
847,20442,20442,20419,23,23.095,914.746,43.506
848,20124,20124,20089,35,107.987,969.143,40.539
849,832,832,832,0,522.142,1.976,32.023
850,20554,20554,20493,61,946.955,14.428,40.457
851,25646,25646,25646,0,415.860,81.681,43.978
852,44744,44744,44676,68,753.559,98.523,49.866
853,24535,24535,24503,32,251.709,95.246,43.176
854,44740,44740,44681,59,400.339,126.197,44.820
855,47965,47965,47929,36,849.770,121.002,51.717
856,2154,2154,2154,0,2.589,222.822,35.473
857,47669,47669,47662,7,473.269,239.561,49.212
858,47702,47702,47702,0,901.719,251.406,49.468
859,44248,44248,44248,0,113.162,272.268,46.649
860,28200,28200,28169,31,252.776,264.790,43.914
861,43723,43723,43583,140,983.490,285.932,47.487
862,23359,23359,23359,0,110.006,382.931,45.020
863,39525,39525,39525,0,452.188,399.310,51.739
864,13670,13670,13670,0,726.630,383.653,44.802
865,38383,38383,38306,77,565.334,460.197,42.804
866,28755,28755,28741,14,383.784,567.259,43.273
867,22517,22517,22517,0,238.184,558.561,44.330
868,24599,24599,24599,0,273.779,559.560,44.325
869,20696,20696,20696,0,140.128,575.056,41.228
870,32936,32936,32924,12,844.312,616.344,48.668
871,23297,23297,23284,13,993.807,665.831,43.968
872,28224,28224,28153,71,543.078,698.478,48.460
873,37586,37586,37585,1,306.826,736.740,46.451
874,26179,26179,26179,0,274.185,736.761,40.739
875,35611,35611,35610,1,450.555,751.683,46.991
876,35691,35691,35682,9,64.315,787.079,51.041
877,47568,47568,47548,20,677.475,801.356,47.433
878,33301,33301,33220,81,535.940,887.757,42.530
879,29102,29102,29102,0,630.721,921.080,42.336
880,37024,37024,37024,0,361.052,946.874,44.871
881,793,793,793,0,316.654,5.197,31.014
882,23803,23803,23786,17,973.467,19.732,42.639
883,30884,30884,30824,60,604.957,40.202,47.272
884,23603,23603,23600,3,880.838,56.911,44.390
885,40012,40012,39768,244,76.330,65.955,48.275
886,23857,23857,23857,0,159.564,131.495,43.108
887,36278,36278,36278,0,989.282,143.105,37.912
888,23563,23563,23563,0,35.744,154.228,46.103
889,25814,25814,25807,7,988.012,384.973,44.162
890,28223,28223,28198,25,920.937,391.905,46.538
891,35829,35829,35805,24,962.682,403.116,49.398
892,35962,35962,35962,0,79.032,436.729,49.493
893,36580,36580,36580,0,611.858,461.089,45.818
894,45610,45610,45363,247,711.344,526.813,49.462
895,24543,24543,24531,12,900.041,589.571,44.448
896,26409,26409,26409,0,443.718,676.809,43.874
897,24334,24334,24315,19,319.965,701.282,44.451
898,49189,49189,49006,183,642.053,733.562,51.389
899,21108,21108,21108,0,867.745,757.252,48.029
900,26209,26209,26209,0,848.954,779.664,43.642
901,29574,29574,29562,12,741.324,783.738,44.469
902,30088,30088,30088,0,508.080,818.513,49.427
903,30169,30169,30169,0,702.819,822.036,45.478
904,30173,30173,30170,3,501.892,854.542,45.858
905,21849,21849,21849,0,10.076,857.557,49.877
906,24073,24073,23873,200,238.293,1012.601,48.397
907,232,232,232,0,309.341,10.353,32.220
908,39380,39380,39380,0,134.031,143.412,51.748
909,39796,39796,39752,44,650.796,152.189,50.247
910,40401,40401,40350,51,90.264,164.832,50.123
911,39759,39759,39759,0,187.965,190.941,51.704
912,40018,40018,40013,5,829.507,184.472,54.716
913,27754,27754,27754,0,423.738,286.252,45.632
914,24164,24164,24164,0,199.758,288.224,44.889
915,22863,22863,22863,0,1009.857,317.642,45.851
916,24617,24617,24617,0,340.991,385.328,45.084
917,15990,15990,15990,0,7.882,400.980,45.315
918,39817,39817,39801,16,326.191,456.165,50.448
919,21678,21678,21678,0,295.163,495.345,49.783
920,23701,23701,23701,0,148.526,495.525,44.991
921,19417,19417,19411,6,146.786,756.233,45.053
922,5088,5088,5088,0,3.994,835.051,44.802
923,34138,34138,33982,156,351.271,994.030,45.095
924,13645,13645,13266,379,207.078,1012.298,40.639
925,23620,23620,23573,47,474.199,1013.661,45.810
926,18760,18760,18743,17,264.061,11.480,43.183
927,40414,40414,40414,0,784.743,25.066,52.519
928,24546,24546,24475,71,285.252,44.810,42.849
929,29511,29511,29491,20,596.436,164.677,46.188
930,31051,31051,31051,0,667.768,191.072,49.432
931,1419,1419,1419,0,116.329,206.991,35.004
932,46409,46409,46398,11,293.449,236.319,51.510
933,39950,39950,39683,267,603.504,258.672,45.172
934,19667,19667,19667,0,81.970,283.304,49.783
935,65449,65449,65447,2,635.673,300.705,52.749
936,31108,31108,31108,0,183.457,306.057,51.599
937,29924,29924,29912,12,861.811,305.077,46.030
938,22454,22454,22454,0,93.067,321.751,48.667
939,27249,27249,27249,0,269.968,377.081,49.833
940,54733,54733,54730,3,741.864,400.168,55.668
941,31145,31145,31125,20,898.141,401.623,52.223
942,25403,25403,25403,0,373.090,457.733,47.302
943,14286,14286,14286,0,1013.883,464.088,44.202
944,37198,37198,37169,29,348.978,479.423,53.495
945,28221,28221,28221,0,13.870,569.141,49.920
946,43502,43502,43458,44,621.018,564.280,50.252
947,42956,42956,42944,12,395.163,615.700,51.712
948,32540,32540,32534,6,517.835,696.416,46.873
949,30989,30989,30989,0,957.586,713.817,49.911
950,29039,29039,29039,0,996.500,719.891,49.709
951,33895,33895,33873,22,410.538,884.403,48.864
952,29988,29988,29876,112,753.271,886.538,47.864
953,24962,24962,24940,22,560.860,902.586,45.630
954,31986,31986,31982,4,255.162,964.354,51.120
955,378,378,378,0,306.439,15.944,39.627
956,22357,22357,22333,24,198.900,48.533,45.978
957,44215,44215,44211,4,661.126,65.083,53.451
958,23596,23596,23556,40,519.869,96.851,48.138
959,41853,41853,41815,38,678.575,106.034,52.004
960,15559,15559,15559,0,5.896,307.927,47.863
961,40954,40954,40954,0,347.568,310.446,51.238
962,27174,27174,27171,3,860.975,331.036,51.140
963,41624,41624,41553,71,482.188,401.941,50.671
964,37817,37817,37817,0,367.920,504.219,50.931
965,19186,19186,19167,19,683.606,510.183,43.713
966,40647,40647,40647,0,432.150,640.158,55.438
967,42794,42794,42711,83,479.404,659.841,52.714
968,22520,22520,22510,10,31.465,679.685,46.570
969,22454,22454,22454,0,217.905,742.470,46.707
970,23306,23306,23306,0,402.745,749.330,49.796
971,26882,26882,26856,26,808.870,797.378,47.654
972,22872,22872,22872,0,829.075,897.510,44.130
973,28591,28591,28573,18,462.552,160.285,45.797
974,4228,4228,4228,0,1016.847,208.413,44.355
975,45438,45438,45251,187,786.457,210.974,54.113
976,11372,11372,11369,3,726.772,502.844,42.805
977,99,99,99,0,718.576,504.354,39.172
978,30305,30305,30305,0,748.351,589.462,44.618
979,38914,38914,38914,0,868.712,608.709,52.481
980,24504,24504,24504,0,280.260,699.798,47.310
981,3758,3758,3714,44,621.417,718.241,39.511
982,31014,31014,31014,0,280.283,845.182,51.800
983,29046,29046,29046,0,691.573,896.845,47.447
984,22206,22206,22206,0,851.256,906.222,46.461
985,35335,35335,35328,7,284.167,924.706,52.304
986,29098,29098,29034,64,522.494,928.510,46.487
987,38417,38417,38417,0,834.450,958.633,52.254
988,43455,43455,43439,16,286.619,1001.379,49.679
989,8634,8634,8539,95,558.461,4.584,49.957
990,25732,25732,25632,100,241.085,47.768,50.156
991,23234,23234,23234,0,323.066,58.468,48.644
992,22596,22596,22534,62,126.484,72.504,46.268
993,32828,32828,32772,56,929.677,74.040,47.849
994,54893,54893,54575,318,913.160,112.855,55.320
995,44931,44931,44931,0,348.783,121.871,54.368
996,27016,27016,26994,22,712.144,123.279,50.381
997,40361,40361,40314,47,482.711,180.693,54.716
998,32699,32699,32699,0,851.496,245.785,53.738
999,34314,34314,34265,49,784.836,281.965,52.727
1000,31084,31084,31084,0,512.377,323.903,52.265
1001,38725,38725,38725,0,882.584,351.658,53.433
1002,43278,43278,43258,20,829.641,345.585,53.769
1003,33761,33761,33761,0,173.581,400.351,53.449
1004,36660,36660,36660,0,770.543,443.591,48.352
1005,32515,32515,32515,0,460.880,452.211,49.682
1006,31808,31808,31803,5,469.247,488.976,50.185
1007,94,94,94,0,719.298,503.968,38.989
1008,26007,26007,26007,0,924.216,510.626,49.361
1009,25522,25522,25522,0,972.362,535.408,48.343
1010,34906,34906,34906,0,361.244,547.675,54.273
1011,23668,23668,23668,0,805.752,552.378,47.623
1012,33325,33325,33322,3,46.397,571.342,52.031
1013,32780,32780,32780,0,352.642,614.540,54.474
1014,42508,42508,42359,149,551.226,605.998,51.615
1015,26461,26461,26461,0,984.235,619.583,48.212
1016,44009,44009,44009,0,902.747,638.942,53.520
1017,26240,26240,26240,0,348.232,681.760,49.066
1018,30720,30720,30685,35,388.113,705.395,48.048
1019,20641,20641,20641,0,102.199,755.085,49.766
1020,31944,31944,31944,0,410.662,779.768,54.652
1021,31349,31349,31278,71,13.254,807.846,53.013
1022,26053,26053,26053,0,64.388,815.268,54.500
1023,34153,34153,34153,0,940.712,950.584,47.394
1024,43092,43092,43019,73,452.150,949.715,53.108
1025,17184,17184,17184,0,656.141,1005.201,42.462
1026,37253,37253,37235,18,332.100,1010.028,56.276
1027,11575,11575,11497,78,862.895,5.964,51.367
1028,22611,22611,22568,43,37.159,102.415,49.681
1029,28846,28846,28846,0,242.329,214.584,50.723
1030,35099,35099,35099,0,508.595,246.357,54.105
1031,30291,30291,30291,0,175.819,232.905,55.049
1032,27107,27107,27107,0,19.369,260.629,54.171
1033,23488,23488,23488,0,39.281,321.631,51.918
1034,24258,24258,24258,0,917.902,345.239,50.600
1035,24247,24247,24247,0,920.388,434.478,51.497
1036,46530,46530,46486,44,531.817,464.111,54.759
1037,34006,34006,34006,0,313.093,524.655,54.515
1038,19506,19506,19506,0,155.478,626.442,47.128
1039,26146,26146,26146,0,706.280,690.636,52.260
1040,36227,36227,36227,0,871.891,706.670,53.468
1041,42494,42494,42494,0,924.952,732.281,51.674
1042,31630,31630,31614,16,608.158,747.968,50.446
1043,13539,13539,13539,0,1014.691,735.404,48.994
1044,20359,20359,20359,0,25.584,768.038,49.381
1045,31215,31215,31215,0,360.248,834.049,56.836
1046,36306,36306,36306,0,91.416,887.669,53.683
1047,28921,28921,28919,2,38.770,886.900,54.054
1048,37512,37512,37509,3,393.400,1011.626,52.191
1049,22283,22283,22258,25,553.562,1008.149,46.789
1050,1324,1324,1324,0,262.208,1020.779,40.884
1051,467,467,467,0,174.105,39.520,37.338
1052,30211,30211,30140,71,15.444,53.745,54.506
1053,26726,26726,26687,39,872.207,89.624,50.670
1054,43258,43258,43258,0,921.320,145.681,54.395
1055,34134,34134,34120,14,355.251,165.221,52.828
1056,53144,53144,53006,138,871.419,170.093,56.026
1057,24659,24659,24659,0,401.120,197.768,52.683
1058,39534,39534,39534,0,346.748,249.265,54.118
1059,25345,25345,25345,0,979.198,352.345,51.481
1060,41319,41319,41228,91,760.983,371.002,50.611
1061,35199,35199,35193,6,429.828,476.311,53.890
1062,31685,31685,31685,0,637.886,466.510,51.293
1063,524,524,524,0,806.691,491.365,38.116
1064,18273,18273,18273,0,105.165,506.258,50.309
1065,49755,49755,49715,40,796.771,486.496,53.931
1066,65196,65196,65188,8,673.020,538.113,55.380
1067,43266,43266,43266,0,896.312,555.160,57.358
1068,42198,42198,42172,26,695.317,643.386,54.922
1069,22135,22135,22135,0,405.870,692.236,54.059
1070,30426,30426,30382,44,454.862,690.244,53.807
1071,28753,28753,28731,22,673.682,677.149,51.512
1072,39705,39705,39705,0,736.865,707.503,55.150
1073,26266,26266,26228,38,638.888,888.482,49.338
1074,2875,2875,2875,0,29.246,1019.435,43.782
1075,6120,6120,6120,0,826.112,1017.235,44.616
1076,4111,4111,4111,0,455.221,3.051,50.508
1077,31641,31641,31525,116,833.181,19.653,53.617
1078,27481,27481,27462,19,449.516,28.385,54.022
1079,32629,32629,32617,12,897.338,44.478,53.893
1080,26597,26597,26597,0,41.910,58.765,55.600
1081,26594,26594,26594,0,209.257,86.522,51.722
1082,23007,23007,23007,0,145.163,110.428,52.321
1083,30289,30289,30289,0,798.817,142.542,53.056
1084,32738,32738,32738,0,161.600,174.761,56.196
1085,18537,18537,18537,0,9.385,191.860,53.561
1086,47395,47395,47349,46,916.132,198.889,55.650
1087,20071,20071,20071,0,202.303,230.751,55.201
1088,22625,22625,22625,0,152.486,291.302,52.975
1089,25529,25529,25529,0,387.895,367.827,55.152
1090,42232,42232,42179,53,788.842,376.894,56.505
1091,19735,19735,19735,0,27.455,433.085,52.022
1092,24424,24424,24424,0,59.526,534.143,52.122
1093,37578,37578,37433,145,638.086,539.926,55.568
1094,48211,48211,48168,43,644.938,635.941,57.939
1095,35725,35725,35629,96,588.413,695.070,53.519
1096,33122,33122,33122,0,174.315,707.351,55.125
1097,20648,20648,20648,0,52.347,762.899,52.362
1098,27256,27256,27233,23,812.006,753.430,52.350
1099,15557,15557,15557,0,607.466,814.380,57.145
1100,8852,8852,8852,0,145.796,860.393,49.317
1101,26831,26831,26600,231,578.891,917.616,53.508
1102,20506,20506,20477,29,72.696,965.899,53.142
1103,24553,24553,24436,117,550.434,115.361,52.865
1104,30682,30682,30682,0,384.376,159.600,55.213
1105,28947,28947,28923,24,931.447,257.183,53.294
1106,44846,44846,44761,85,704.869,258.326,52.256
1107,27977,27977,27977,0,895.078,283.544,57.354
1108,29132,29132,29132,0,322.941,609.981,57.049
1109,31551,31551,31551,0,945.378,617.636,56.124
1110,22174,22174,22174,0,157.736,650.438,52.125
1111,24239,24239,24232,7,293.926,659.080,50.786
1112,35534,35534,35534,0,962.134,674.146,56.121
1113,38243,38243,38243,0,890.869,672.204,54.452
1114,23065,23065,23065,0,208.979,691.452,53.277
1115,24314,24314,24284,30,557.321,705.998,56.174
1116,52263,52263,52145,118,529.638,739.799,55.757
1117,28542,28542,28542,0,243.625,760.176,54.047
1118,31496,31496,31496,0,311.925,830.641,56.034
1119,43918,43918,43905,13,791.866,918.325,56.241
1120,42468,42468,42366,102,336.231,965.442,57.381
1121,11259,11259,11259,0,672.508,7.250,56.666
1122,21421,21421,21406,15,1006.057,13.318,56.319
1123,27316,27316,27166,150,531.670,49.804,53.177
1124,24529,24529,24514,15,694.016,84.085,55.046
1125,52351,52351,52351,0,247.265,133.111,52.757
1126,30723,30723,30723,0,216.584,191.844,57.920
1127,19827,19827,19827,0,218.222,276.383,55.871
1128,23032,23032,23029,3,351.988,341.282,55.968
1129,23194,23194,23194,0,92.165,344.509,56.800
1130,34129,34129,34086,43,590.042,491.218,55.032
1131,35648,35648,35589,59,741.406,458.906,55.943
1132,30678,30678,30664,14,619.856,498.859,57.231
1133,5822,5822,5822,0,1017.951,519.475,50.460
1134,35611,35611,35602,9,851.689,573.799,56.755
1135,23447,23447,23447,0,67.468,579.332,55.541
1136,24338,24338,24338,0,96.266,705.314,53.624
1137,25908,25908,25908,0,237.926,723.136,54.864
1138,22125,22125,22125,0,342.793,718.917,53.978
1139,23093,23093,23093,0,297.696,763.850,54.160
1140,383,383,383,0,557.838,813.321,47.457
1141,1708,1708,1703,5,557.434,811.920,49.213
1142,18362,18362,18362,0,547.606,794.867,55.290
1143,24596,24596,24596,0,377.512,800.360,53.583
1144,48658,48658,48650,8,178.605,847.596,55.650
1145,20195,20195,20195,0,978.458,908.021,50.249
1146,30568,30568,30275,293,447.520,913.017,55.221
1147,18466,18466,18466,0,989.106,966.103,51.323
1148,1971,1971,1971,0,4.402,1014.194,43.930
1149,6189,6189,6189,0,400.211,4.264,51.730
1150,187,187,187,0,314.139,17.096,44.930
1151,35613,35613,35606,7,403.989,59.090,56.245
1152,25396,25396,25350,46,616.960,69.625,57.435
1153,27879,27879,27879,0,69.109,262.070,57.249
1154,34844,34844,34804,40,796.372,304.480,58.458
1155,32715,32715,32715,0,193.444,367.747,56.209
1156,38524,38524,38502,22,575.253,409.216,51.101
1157,17480,17480,17480,0,110.522,407.246,57.019
1158,23687,23687,23687,0,386.858,418.281,56.165
1159,25305,25305,25305,0,199.717,431.461,55.836
1160,27908,27908,27908,0,455.789,551.105,56.704
1161,26029,26029,26029,0,169.077,594.112,57.300
1162,22734,22734,22732,2,380.967,590.570,56.427
1163,34571,34571,34571,0,128.004,714.867,56.595
1164,29345,29345,29306,39,493.466,759.831,56.752
1165,17857,17857,17857,0,298.350,790.131,56.186
1166,6180,6180,6180,0,1018.844,798.275,51.754
1167,218,218,217,1,558.349,812.092,47.716
1168,24997,24997,24952,45,419.652,809.401,56.487
1169,29778,29778,29754,24,525.824,813.271,57.625
1170,23199,23199,23175,24,81.922,845.227,53.870
1171,21969,21969,21712,257,554.203,961.273,50.972
1172,19363,19363,19363,0,751.930,12.541,57.029
1173,22377,22377,22290,87,246.747,16.679,56.892
1174,23083,23083,23053,30,531.709,17.776,55.579
1175,33559,33559,33506,53,351.438,83.506,56.953
1176,24700,24700,24700,0,63.986,133.868,55.887
1177,31670,31670,31657,13,558.797,191.999,57.192
1178,37514,37514,37259,255,712.048,199.535,53.294
1179,35791,35791,35753,38,549.815,271.985,55.760
1180,26186,26186,26186,0,165.360,335.303,56.672
1181,14997,14997,14997,0,128.396,368.980,55.836
1182,21258,21258,21258,0,260.324,451.984,55.619
1183,3796,3796,3796,0,98.505,472.683,46.533
1184,485,485,485,0,678.431,496.676,48.880
1185,20059,20059,20048,11,159.998,554.200,55.968
1186,19780,19780,19780,0,255.262,570.947,56.887
1187,18199,18199,18198,1,1009.539,588.550,55.776
1188,27845,27845,27845,0,263.895,597.966,56.627
1189,20503,20503,20500,3,53.412,640.593,55.243
1190,19778,19778,19778,0,222.373,660.815,55.802
1191,6374,6374,6374,0,4.807,670.518,49.785
1192,22078,22078,22071,7,12.538,712.562,54.906
1193,29359,29359,29176,183,574.618,731.362,58.040
1194,26276,26276,26250,26,729.203,743.862,57.319
1195,29326,29326,29326,0,352.460,753.260,56.495
1196,26733,26733,26707,26,245.224,843.360,54.098
1197,22724,22724,22724,0,335.329,846.077,54.292
1198,25158,25158,25158,0,984.072,940.480,59.180
1199,55435,55435,55418,17,510.551,955.451,56.935
1200,41599,41599,41489,110,213.925,994.832,58.216
1201,12446,12446,12446,0,219.915,9.003,56.216
1202,17642,17642,17610,32,122.232,57.124,57.398
1203,33764,33764,33753,11,805.061,68.798,56.967
1204,22547,22547,22538,9,872.822,114.098,58.658
1205,18247,18247,18247,0,383.811,229.957,61.645
1206,26591,26591,26591,0,806.094,226.847,58.819
1207,18221,18221,18221,0,9.466,226.790,56.021
1208,35652,35652,35652,0,732.057,271.393,57.748
1209,30953,30953,30949,4,374.257,279.034,56.921
1210,41900,41900,41897,3,712.940,350.533,57.242
1211,23859,23859,23859,0,233.559,366.734,56.295
1212,21209,21209,21209,0,318.801,372.258,54.890
1213,26240,26240,26240,0,253.136,397.278,57.947
1214,23074,23074,23074,0,220.190,485.284,55.481
1215,47311,47311,47213,98,721.117,489.867,58.017
1216,31769,31769,31610,159,666.106,482.695,60.259
1217,29635,29635,29587,48,589.536,570.445,59.620
1218,40902,40902,40863,39,586.197,615.612,57.943
1219,31904,31904,31856,48,693.677,725.775,57.096
1220,28822,28822,28822,0,229.988,785.281,57.032
1221,29284,29284,29283,1,197.626,819.351,57.772
1222,20677,20677,20677,0,130.938,824.467,55.967
1223,25876,25876,25864,12,388.153,839.280,58.214
1224,36629,36629,36629,0,716.958,857.463,57.962
1225,35663,35663,35565,98,268.791,877.161,56.215
1226,17984,17984,17975,9,991.053,1006.411,50.883
1227,21130,21130,21121,9,174.416,17.041,55.993
1228,20020,20020,20018,2,623.471,30.070,56.875
1229,37451,37451,37418,33,440.613,77.897,58.190
1230,23658,23658,23658,0,293.168,142.198,57.369
1231,25706,25706,25706,0,446.406,309.605,58.036
1232,24265,24265,24265,0,414.488,322.057,59.165
1233,21673,21673,21661,12,212.428,330.945,58.238
1234,21794,21794,21792,2,62.131,408.849,57.137
1235,6438,6438,6438,0,659.460,417.656,50.549
1236,18833,18833,18785,48,962.876,424.689,57.604
1237,21548,21548,21548,0,436.677,441.696,58.773
1238,18845,18845,18841,4,1011.408,487.658,59.728
1239,29272,29272,29271,1,507.159,514.919,57.317
1240,16128,16128,16122,6,948.779,516.469,57.951
1241,31297,31297,31189,108,771.067,522.933,58.772
1242,17332,17332,17332,0,126.985,544.015,55.801
1243,25660,25660,25626,34,970.631,590.672,58.337
1244,27482,27482,27363,119,780.424,616.403,56.781
1245,25364,25364,25364,0,238.839,641.032,59.558
1246,37450,37450,37414,36,558.293,655.633,57.983
1247,22925,22925,22922,3,928.024,678.208,56.649
1248,28622,28622,28619,3,246.568,683.709,57.506
1249,26100,26100,26100,0,829.694,736.887,58.040
1250,23961,23961,23945,16,566.771,766.887,60.011
1251,22061,22061,22061,0,161.823,782.617,56.535
1252,21968,21968,21968,0,935.196,793.039,57.311
1253,19355,19355,19355,0,38.968,818.890,57.273
1254,22844,22844,22768,76,672.204,856.830,58.162
1255,28447,28447,28355,92,461.801,883.888,57.183
1256,18859,18859,18859,0,54.072,919.782,55.887
1257,25084,25084,25031,53,139.439,917.770,54.065
1258,19564,19564,19564,0,20.094,982.462,56.245
1259,33981,33981,33894,87,800.187,1001.300,57.845
1260,11739,11739,11739,0,766.474,1015.656,59.095
1261,23694,23694,23666,28,96.386,43.991,58.490
1262,24113,24113,24104,9,1008.445,44.508,59.360
1263,19994,19994,19981,13,122.397,309.340,57.010
1264,27032,27032,27014,18,482.131,311.472,59.974
1265,23701,23701,23701,0,447.017,354.653,59.809
1266,19902,19902,19902,0,21.017,370.831,58.381
1267,25204,25204,25137,67,711.226,424.411,59.695
1268,20290,20290,20290,0,222.877,567.101,57.396
1269,23630,23630,23605,25,300.492,584.050,56.272
1270,15817,15817,15817,0,14.531,624.290,58.328
1271,34761,34761,34751,10,637.012,682.918,59.738
1272,15131,15131,15131,0,1013.943,689.321,58.435
1273,18657,18657,18638,19,48.239,704.820,57.918
1274,17567,17567,17567,0,206.150,717.756,57.995
1275,17502,17502,17502,0,11.903,745.358,55.698
1276,26129,26129,26128,1,824.671,857.695,57.473
1277,32329,32329,32237,92,631.188,859.327,58.364
1278,28416,28416,28407,9,225.942,893.187,58.558
1279,26439,26439,26439,0,626.475,917.828,59.573
1280,21940,21940,21938,2,924.770,41.731,59.173
1281,20093,20093,20093,0,714.502,70.886,59.654
1282,25805,25805,25756,49,479.331,102.587,59.345
1283,24309,24309,24309,0,947.713,82.702,58.867
1284,15599,15599,15599,0,118.034,172.377,58.456
1285,21995,21995,21936,59,63.533,184.428,59.725
1286,22117,22117,22117,0,935.148,324.768,59.949
1287,19248,19248,19248,0,357.338,369.296,59.273
1288,1342,1342,1342,0,39.636,481.230,47.823
1289,17610,17610,17595,15,757.501,483.338,60.056
1290,19386,19386,19386,0,278.432,523.807,58.325
1291,17067,17067,16964,103,400.895,546.399,59.728
1292,21647,21647,21647,0,922.297,592.118,59.662
1293,22745,22745,22745,0,426.037,710.733,59.353
1294,20423,20423,20423,0,178.961,744.093,57.260
1295,22041,22041,22041,0,450.234,792.348,59.257
1296,25265,25265,25254,11,556.874,834.497,59.100
1297,17052,17052,17010,42,312.782,919.375,58.988
1298,25618,25618,25618,0,694.205,927.651,57.576
1299,17583,17583,17427,156,538.597,941.042,62.236
1300,16462,16462,16441,21,97.947,967.612,59.222
1301,35853,35853,35816,37,468.885,992.216,60.048
1302,24781,24781,24712,69,997.154,280.191,60.175
1303,17338,17338,17338,0,390.423,318.583,58.612
1304,33630,33630,33609,21,638.425,349.484,58.840
1305,28450,28450,28450,0,1005.075,360.576,58.824
1306,30175,30175,30155,20,553.484,369.165,59.267
1307,20011,20011,20011,0,398.407,444.339,60.005
1308,22163,22163,22163,0,899.462,469.976,58.277
1309,3910,3910,3910,0,211.249,519.250,51.172
1310,12325,12325,12325,0,29.388,544.916,58.357
1311,13393,13393,13385,8,24.959,650.731,58.953
1312,21298,21298,21298,0,404.938,660.857,59.572
1313,29348,29348,29333,15,723.877,667.484,58.118
1314,29713,29713,29713,0,655.960,762.118,60.037
1315,17588,17588,17588,0,407.034,910.544,60.901
1316,22789,22789,22676,113,306.522,958.339,60.308
1317,14834,14834,14811,23,70.461,30.099,59.413
1318,23540,23540,23540,0,506.450,58.514,58.962
1319,24450,24450,24450,0,65.861,102.110,59.578
1320,18793,18793,18793,0,196.136,143.111,59.273
1321,22844,22844,22844,0,276.113,420.455,58.295
1322,9209,9209,9209,0,155.704,445.591,58.682
1323,16059,16059,16059,0,178.540,481.644,58.127
1324,19618,19618,19603,15,92.928,660.809,58.358
1325,19400,19400,19400,0,793.621,823.414,59.606
1326,18192,18192,18115,77,425.877,859.754,61.229
1327,7786,7786,7786,0,105.436,1015.042,57.093
1328,8122,8122,8122,0,928.365,1016.111,60.930
1329,9628,9628,9628,0,93.268,10.206,60.635
1330,20751,20751,20688,63,284.904,19.766,59.338
1331,25884,25884,25884,0,753.309,142.791,59.295
1332,20414,20414,20414,0,41.782,209.054,60.184
1333,19959,19959,19959,0,309.298,262.801,60.085
1334,388,388,388,0,158.941,352.397,50.923
1335,13862,13862,13862,0,78.896,369.632,60.108
1336,16186,16186,16186,0,156.201,378.732,60.320
1337,19464,19464,19464,0,995.087,423.572,60.127
1338,15705,15705,15705,0,417.012,598.342,60.452
1339,26567,26567,26567,0,787.060,698.462,61.219
1340,16654,16654,16654,0,1005.943,760.055,58.163
1341,2897,2897,2897,0,2.888,772.180,58.710
1342,15370,15370,15362,8,116.397,923.758,60.377
1343,17314,17314,17289,25,366.096,929.509,60.766
1344,17203,17203,17101,102,469.795,929.692,60.388
1345,33623,33623,33450,173,420.556,982.251,60.534
1346,19237,19237,19227,10,277.567,990.521,59.555
1347,16621,16621,16621,0,985.240,124.465,60.666
1348,15101,15101,15101,0,265.517,167.473,61.599
1349,14989,14989,14989,0,216.692,253.607,60.371
1350,18646,18646,18646,0,414.011,266.059,60.670
1351,26763,26763,26763,0,683.351,291.503,61.462
1352,15186,15186,15186,0,44.083,291.926,61.350
1353,11692,11692,11692,0,351.860,430.166,61.160
1354,20766,20766,20766,0,831.843,460.129,60.905
1355,14861,14861,14861,0,1007.349,540.576,60.742
1356,25545,25545,25544,1,687.217,580.671,60.419
1357,18579,18579,18579,0,667.962,704.120,59.943
1358,15760,15760,15720,40,603.810,713.336,60.274
1359,14682,14682,14682,0,325.273,778.412,59.877
1360,15564,15564,15564,0,320.422,868.021,60.750
1361,21524,21524,21471,53,484.767,854.996,61.112
1362,28566,28566,28494,72,492.916,893.517,60.561
1363,12209,12209,12195,14,645.391,34.652,61.142
1364,19245,19245,19206,39,833.789,51.325,61.267
1365,16180,16180,16180,0,972.896,66.949,60.804
1366,15453,15453,15448,5,454.612,259.482,61.610
1367,12579,12579,12573,6,249.043,325.677,62.424
1368,21751,21751,21751,0,856.167,381.430,60.808
1369,23131,23131,23131,0,946.660,461.953,62.023
1370,17801,17801,17801,0,920.866,487.370,61.869
1371,16071,16071,16071,0,456.363,510.729,62.457
1372,15739,15739,15739,0,386.329,524.413,61.780
1373,16742,16742,16742,0,941.233,544.939,60.761
1374,13078,13078,13078,0,96.441,558.877,59.841
1375,18997,18997,18954,43,427.276,559.571,60.468
1376,6501,6501,6501,0,1015.421,615.489,61.263
1377,27682,27682,27625,57,600.001,653.791,61.781
1378,25337,25337,25337,0,902.300,944.671,61.009
1379,6495,6495,6495,0,617.629,6.198,61.578
1380,15650,15650,15650,0,728.599,42.608,61.620
1381,18670,18670,18663,7,467.748,138.654,61.855
1382,30536,30536,30439,97,517.808,171.852,61.286
1383,18072,18072,18072,0,665.602,217.929,62.182
1384,14830,14830,14737,93,603.283,218.213,62.563
1385,21550,21550,21549,1,827.888,279.261,62.430
1386,21518,21518,21439,79,751.228,327.889,61.938
1387,29055,29055,28912,143,673.261,435.201,61.415
1388,20676,20676,20568,108,486.698,475.577,61.904
1389,15224,15224,15224,0,393.121,483.399,61.549
1390,18053,18053,18022,31,777.877,560.459,61.222
1391,17615,17615,17615,0,742.457,593.715,61.125
1392,23008,23008,23008,0,466.405,607.456,61.309
1393,14258,14258,14258,0,160.497,673.148,61.695
1394,14331,14331,14331,0,976.287,740.701,61.462
1395,16564,16564,16564,0,280.141,745.818,61.413
1396,12438,12438,12438,0,741.908,766.203,61.691
1397,23558,23558,23553,5,621.097,780.983,61.505
1398,14463,14463,14462,1,581.052,854.649,62.595
1399,17650,17650,17601,49,651.535,901.324,61.991
1400,8055,8055,8052,3,12.098,916.398,61.420
1401,15755,15755,15748,7,163.724,1006.529,61.046
1402,7406,7406,7404,2,196.278,8.794,61.932
1403,1512,1512,1512,0,42.218,3.014,60.263
1404,15016,15016,15016,0,153.455,77.499,62.174
1405,20739,20739,20721,18,582.234,92.659,61.612
1406,16642,16642,16616,26,966.866,227.295,62.418
1407,13242,13242,13242,0,170.684,264.966,62.350
1408,11582,11582,11582,0,972.074,316.460,61.798
1409,15282,15282,15276,6,825.202,387.339,62.427
1410,18917,18917,18899,18,778.631,431.917,62.344
1411,11217,11217,11217,0,244.327,472.401,61.987
1412,3741,3741,3741,0,56.439,486.401,58.630
1413,6770,6770,6770,0,53.443,502.001,60.742
1414,4670,4670,4670,0,238.849,510.436,60.105
1415,12851,12851,12823,28,654.879,563.991,62.452
1416,22010,22010,22010,0,490.933,560.293,62.059
1417,14031,14031,14031,0,277.086,622.674,61.404
1418,11412,11412,11412,0,132.284,647.829,61.118
1419,13467,13467,13462,5,313.255,656.308,61.336
1420,12786,12786,12786,0,299.988,691.376,62.439
1421,17804,17804,17804,0,707.794,789.314,61.679
1422,17426,17426,17426,0,753.005,848.599,60.974
1423,14440,14440,14440,0,905.047,885.897,61.520
1424,19282,19282,19276,6,694.838,968.672,61.154
1425,17216,17216,17216,0,749.873,963.627,61.790
1426,21151,21151,21052,99,661.080,974.221,61.336
1427,14132,14132,14132,0,861.285,968.443,61.746
1428,16050,16050,16046,4,697.484,1003.496,61.359
1429,7454,7454,7454,0,643.455,8.524,61.439
1430,11982,11982,11982,0,890.104,78.265,63.246
1431,10011,10011,10011,0,258.757,76.337,63.083
1432,10208,10208,10208,0,181.486,83.094,62.360
1433,14218,14218,14218,0,973.668,150.636,62.070
1434,13908,13908,13908,0,444.907,163.656,62.596
1435,3916,3916,3916,0,811.836,287.822,61.106
1436,17019,17019,17019,0,572.422,300.069,62.338
1437,14091,14091,14020,71,813.543,429.181,63.033
1438,13333,13333,13333,0,975.634,560.102,62.002
1439,11896,11896,11896,0,140.624,603.036,62.713
1440,12038,12038,11948,90,803.771,617.298,62.346
1441,17854,17854,17854,0,738.815,644.303,63.369
1442,12366,12366,12366,0,817.003,667.005,63.008
1443,14166,14166,14166,0,375.580,688.552,62.863
1444,12429,12429,12429,0,466.636,702.325,62.626
1445,12631,12631,12631,0,41.737,732.194,61.575
1446,13496,13496,13496,0,884.298,736.112,61.913
1447,13204,13204,13204,0,136.769,745.250,62.619
1448,14673,14673,14673,0,774.093,775.875,61.945
1449,15929,15929,15929,0,486.078,790.022,62.733
1450,10287,10287,10287,0,505.602,836.192,64.035
1451,13838,13838,13838,0,454.031,841.956,62.760
1452,11700,11700,11700,0,173.769,920.090,62.256
1453,14697,14697,14697,0,28.933,940.314,61.436
1454,15471,15471,15471,0,199.127,946.436,61.861
1455,10714,10714,10707,7,431.246,1014.385,63.280
1456,13191,13191,13191,0,238.970,102.213,62.829
1457,9464,9464,9464,0,1013.925,95.060,62.766
1458,11496,11496,11496,0,970.244,100.979,62.569
1459,13884,13884,13884,0,782.101,121.253,62.128
1460,11069,11069,11069,0,947.096,128.056,62.645
1461,11514,11514,11510,4,1008.754,148.418,62.508
1462,16835,16835,16801,34,960.672,178.365,62.765
1463,7257,7257,7257,0,1010.577,187.408,63.912
1464,8358,8358,8358,0,55.536,362.360,62.190
1465,3366,3366,3366,0,134.131,462.387,61.756
1466,4099,4099,4099,0,91.080,483.441,61.968
1467,29699,29699,29687,12,497.839,604.881,61.573
1468,10708,10708,10708,0,108.432,641.285,62.919
1469,13947,13947,13947,0,768.463,736.694,62.893
1470,10845,10845,10845,0,805.089,771.425,63.359
1471,13280,13280,13280,0,230.875,820.567,62.764
1472,9645,9645,9604,41,601.570,845.597,61.998
1473,16184,16184,16184,0,528.652,888.083,63.595
1474,10919,10919,10919,0,345.849,903.555,63.638
1475,11426,11426,11426,0,131.544,957.099,62.032
1476,17486,17486,17408,78,589.013,987.970,62.857
1477,2838,2838,2838,0,575.278,1020.244,60.926
1478,1132,1132,1132,0,728.469,3.275,63.095
1479,11386,11386,11384,2,161.802,38.671,63.268
1480,15124,15124,14988,136,215.602,50.930,63.007
1481,14593,14593,14593,0,567.354,51.334,62.887
1482,13117,13117,13117,0,197.988,110.582,63.386
1483,11604,11604,11604,0,272.524,208.327,63.344
1484,9378,9378,9378,0,925.057,221.912,63.827
1485,9267,9267,9267,0,941.736,285.733,63.931
1486,11378,11378,11378,0,933.568,417.913,63.082
1487,6153,6153,6153,0,9.631,453.167,61.866
1488,829,829,829,0,67.170,494.256,62.801
1489,5543,5543,5543,0,76.239,494.612,63.035
1490,10579,10579,10548,31,795.044,587.963,62.786
1491,7950,7950,7950,0,71.918,675.443,62.587
1492,7518,7518,7518,0,353.477,700.958,63.916
1493,9488,9488,9488,0,350.329,789.622,62.664
1494,10056,10056,10056,0,570.089,814.366,63.823
1495,10322,10322,10314,8,674.486,820.124,63.753
1496,9638,9638,9638,0,58.837,980.228,62.771
1497,11955,11955,11938,17,84.151,1002.810,62.864
1498,8270,8270,8270,0,263.301,252.120,63.974
1499,14236,14236,14236,0,416.306,386.621,63.761
1500,4025,4025,4025,0,90.360,460.126,63.206
1501,683,683,683,0,77.794,488.426,59.836
1502,12991,12991,12991,0,809.271,513.635,63.539
1503,12393,12393,12393,0,718.353,600.613,63.368
1504,5507,5507,5507,0,940.757,851.819,62.994
1505,13333,13333,13295,38,116.843,870.442,63.160
1506,9927,9927,9883,44,773.660,983.231,63.467
1507,14752,14752,14648,104,502.036,995.844,64.282
1508,11487,11487,11468,19,547.858,1007.947,63.957
1509,9828,9828,9828,0,837.424,1010.209,63.142
1510,7784,7784,7784,0,894.732,1011.838,63.025
1511,155,155,155,0,722.858,3.490,62.781
1512,14073,14073,14073,0,327.088,33.654,63.066
1513,9163,9163,9163,0,428.567,25.505,63.569
1514,9284,9284,9284,0,504.226,90.231,63.381
1515,3578,3578,3578,0,871.470,136.253,63.988
1516,6441,6441,6441,0,38.009,141.488,64.154
1517,12101,12101,12099,2,460.125,209.330,64.081
1518,5012,5012,5012,0,53.780,333.855,64.240
1519,4206,4206,4206,0,189.606,500.943,63.694
1520,8423,8423,8421,2,146.713,805.689,63.608
1521,7363,7363,7363,0,354.759,871.515,64.810
1522,10601,10601,10505,96,421.079,945.196,64.705
1523,4783,4783,4783,0,672.204,1016.937,64.048
1524,477,477,477,0,23.524,208.730,61.771
1525,4243,4243,4243,0,1016.200,241.901,64.580
1526,4513,4513,4513,0,147.672,270.197,63.349
1527,7874,7874,7874,0,861.934,288.234,64.168
1528,4143,4143,4143,0,9.833,287.321,63.278
1529,4449,4449,4449,0,119.717,344.116,63.811
1530,5688,5688,5688,0,31.320,405.439,63.372
1531,8941,8941,8941,0,876.093,432.417,63.756
1532,2882,2882,2882,0,154.414,481.200,64.215
1533,294,294,294,0,83.626,487.350,63.442
1534,9389,9389,9389,0,807.175,549.192,64.575
1535,8714,8714,8714,0,838.293,693.095,63.766
1536,5804,5804,5804,0,924.757,821.567,64.332
1537,5884,5884,5884,0,79.109,927.576,63.992
1538,7753,7753,7753,0,166.827,963.630,64.816
1539,6242,6242,6242,0,41.381,989.975,63.832
1540,1296,1296,1296,0,121.613,3.201,63.902
1541,7682,7682,7682,0,1000.265,70.548,64.314
1542,8282,8282,8282,0,767.821,80.968,64.607
1543,10305,10305,10305,0,300.036,175.020,64.144
1544,10124,10124,10124,0,961.798,260.686,64.122
1545,1513,1513,1513,0,272.998,356.884,64.562
1546,7551,7551,7551,0,941.655,357.882,64.471
1547,7969,7969,7969,0,945.462,380.572,64.247
1548,4439,4439,4439,0,221.243,512.318,64.998
1549,2222,2222,2222,0,153.301,534.860,65.297
1550,10090,10090,10077,13,529.766,568.382,64.932
1551,3805,3805,3805,0,610.487,736.244,66.037
1552,90,90,90,0,514.656,887.567,60.878
1553,6130,6130,6111,19,823.320,921.144,64.946
1554,284,284,284,0,966.972,940.359,61.940
1555,9615,9615,9615,0,606.946,947.176,64.648
1556,628,628,620,8,513.382,1020.124,63.570
1557,1092,1092,1092,0,139.266,1020.205,62.289
1558,7024,7024,7024,0,365.237,8.506,64.646
1559,1402,1402,1402,0,498.293,3.192,65.462
1560,7332,7332,7332,0,504.717,23.613,64.760
1561,6525,6525,6435,90,928.040,20.867,65.278
1562,6673,6673,6673,0,353.635,42.679,64.675
1563,8484,8484,8480,4,383.256,42.796,64.550
1564,106,106,106,0,110.906,342.019,62.972
1565,428,428,428,0,208.327,452.231,62.666
1566,79,79,79,0,675.215,509.886,67.025
1567,273,273,273,0,13.678,581.842,64.777
1568,8902,8902,8871,31,469.075,735.082,64.633
1569,1526,1526,1526,0,941.818,838.853,64.102
1570,2337,2337,2337,0,470.613,75.379,66.268
1571,4291,4291,4291,0,98.606,96.003,64.984
1572,5947,5947,5947,0,431.927,133.409,65.815
1573,3056,3056,3056,0,978.456,205.241,65.497
1574,1686,1686,1686,0,280.486,358.065,66.564
1575,2407,2407,2407,0,1018.081,393.595,65.610
1576,1618,1618,1618,0,221.509,464.651,65.052
1577,1028,1028,1028,0,171.401,461.761,65.305
1578,6608,6608,6574,34,713.582,539.052,65.355
1579,3730,3730,3730,0,193.972,677.908,65.465
1580,5032,5032,5032,0,687.314,762.547,65.327
1581,6707,6707,6707,0,92.289,796.032,65.032
1582,4430,4430,4430,0,882.434,822.722,65.191
1583,4099,4099,4099,0,752.789,874.926,65.347
1584,4557,4557,4430,127,40.521,22.298,65.568
1585,2284,2284,2284,0,1012.711,124.408,65.803
1586,2978,2978,2978,0,329.970,212.063,65.889
1587,2601,2601,2601,0,128.428,257.314,64.967
1588,2705,2705,2705,0,1014.552,303.435,66.530
1589,2649,2649,2649,0,151.766,314.233,65.091
1590,268,268,268,0,157.507,434.362,64.907
1591,5187,5187,5187,0,868.133,463.809,65.623
1592,3531,3531,3503,28,883.218,519.641,65.457
1593,5297,5297,5295,2,737.570,533.630,65.611
1594,1421,1421,1421,0,1000.705,666.266,65.918
1595,4764,4764,4764,0,100.298,728.617,65.545
1596,2293,2293,2293,0,933.728,765.645,65.633
1597,4574,4574,4574,0,837.798,832.199,65.473
1598,1540,1540,1540,0,703.510,116.448,66.866
1599,228,228,228,0,346.991,273.605,65.461
1600,2738,2738,2738,0,351.085,281.499,65.630
1601,946,946,946,0,599.352,305.860,66.200
1602,67,67,67,0,155.388,439.642,66.881
1603,702,702,702,0,1017.266,455.989,64.259
1604,104,104,104,0,189.452,687.385,64.173
1605,3433,3433,3433,0,135.783,852.731,66.168
1606,2207,2207,2207,0,688.167,863.451,66.174
1607,343,343,343,0,136.204,922.813,65.802
1608,467,467,467,0,55.330,241.317,65.792
1609,1258,1258,1258,0,819.317,315.785,66.349
1610,426,426,426,0,967.291,480.594,66.915
1611,1173,1173,1173,0,135.221,520.346,66.241
1612,1387,1387,1387,0,254.850,525.637,66.478
1613,132,132,132,0,62.818,540.727,66.909
1614,441,441,441,0,17.692,582.710,65.422
1615,2985,2985,2985,0,70.495,724.410,66.101
1616,248,248,248,0,256.145,730.387,64.435
1617,4325,4325,4325,0,266.306,781.370,66.246
1618,2627,2627,2627,0,114.332,829.959,66.274
1619,2820,2820,2820,0,145.200,891.176,66.185
1620,1454,1454,1454,0,951.094,919.925,66.685
1621,322,322,322,0,326.773,935.953,65.469
1622,2549,2549,2549,0,50.124,1014.890,66.121
1623,1563,1563,1563,0,574.133,5.106,66.667
1624,1590,1590,1590,0,9.353,8.392,66.698
1625,1756,1756,1756,0,402.471,96.062,66.853
1626,2498,2498,2498,0,538.219,128.076,67.203
1627,1576,1576,1576,0,545.742,222.390,67.072
1628,1169,1169,1169,0,243.639,265.862,67.029
1629,989,989,989,0,99.798,287.824,66.215
1630,261,261,261,0,82.146,309.157,67.341
1631,741,741,741,0,330.221,331.973,68.043
1632,702,702,702,0,101.413,388.009,65.956
1633,839,839,839,0,802.334,401.503,66.982
1634,4126,4126,4126,0,534.731,425.399,66.672
1635,236,236,236,0,137.339,529.411,65.496
1636,3340,3340,3340,0,324.790,571.020,66.602
1637,296,296,296,0,963.115,618.679,66.419
1638,2082,2082,2082,0,218.690,856.826,66.696
1639,2661,2661,2661,0,559.007,884.245,66.653
1640,379,379,379,0,326.198,940.483,66.551
1641,2199,2199,2199,0,634.708,989.197,66.741
1642,65,65,65,0,544.662,213.169,67.292
1643,1263,1263,1263,0,868.148,226.923,67.260
1644,2075,2075,2075,0,306.324,427.941,66.943
1645,664,664,664,0,294.452,477.553,66.880
1646,913,913,913,0,328.751,498.141,66.988
1647,1147,1147,1147,0,544.616,912.861,66.946
1648,555,555,555,0,125.514,20.805,67.308
1649,288,288,288,0,430.851,50.441,67.372
1650,115,115,115,0,327.470,324.243,68.304
1651,870,870,870,0,908.562,380.760,67.694
1652,794,794,794,0,383.547,767.166,67.258
1653,638,638,638,0,331.661,817.412,67.337
1654,1067,1067,1067,0,855.551,918.651,67.236
1655,500,500,500,0,907.524,980.438,67.310
1656,919,919,919,0,875.386,992.448,67.303
1657,821,821,821,0,600.474,1014.613,67.449
1658,530,530,507,23,494.345,1020.302,67.421
1659,709,709,709,0,396.492,16.992,67.700
1660,911,911,911,0,382.923,84.465,67.659
1661,884,884,884,0,298.903,296.420,67.766
1662,511,511,511,0,886.742,309.448,67.699
